.....................
.......^.............
.......^^............
.......^^^...........
......^^.^^..........
......^^..^^.........
.......^.............
.....................

